-10
10
-18
7
000000000000000000000
111111111111111111110
100000000000000000010
100000000000000000010
100000000000000000010
111111111111111111110
100001000000100111010
100000000000000111010
100000000000000000010
100000000000000000010
101110000000000000010
100010000000000000010
100000000000001000010
100000000000001000010
100000010000001000010
100000010000000000010
100000011100000000010
100000000000000000010
100000000000000000010
100000000001111000010
101010000001000000010
101010000001000000010
101110000001111000010
100000000000000000010
100000000000000000010
111111111111111111110
