-9
9
-6
5
0000000000000000000
0000001111111111110
0000001000010000010
0000001000110000010
1111111000010000010
0000000000010000010
0000000000010000010
1111111000010000010
0000001000011111110
0000001000000000010
0000001111111111110
0000000000000000000
